20 20
0 0
3:0 1:0 0:0 0:0 0:0 0:0 0:0 0:0 0:0 0:0 0:0 0:0 0:0 0:0 0:0 0:0 0:0 0:0 0:0 3:0
3:0 1:0 0:0 0:0 0:0 0:0 0:0 0:0 0:0 0:0 0:0 0:0 0:0 0:0 0:0 0:0 0:0 0:0 0:0 3:0
3:0 1:0 0:0 0:0 0:0 0:0 0:0 0:0 0:0 0:0 0:0 0:0 0:0 0:0 0:0 0:0 0:0 0:0 0:0 3:0
3:0 1:0 0:0 0:0 0:0 0:0 0:0 0:0 0:0 0:0 0:0 0:0 0:0 0:0 0:0 0:0 0:0 0:0 0:0 3:0
3:0 1:0 1:0 0:0 0:0 0:0 0:0 0:0 0:0 0:0 0:0 0:0 0:0 0:0 0:0 0:0 0:0 0:0 0:0 3:0
3:0 0:0 1:0 1:0 0:0 0:0 0:0 0:0 0:0 0:0 0:0 0:0 0:0 0:0 0:0 0:0 0:0 0:0 0:0 3:0
3:0 0:0 1:0 1:0 0:0 0:0 0:0 0:0 0:0 0:0 0:0 0:0 0:0 0:0 0:0 0:0 0:0 0:0 0:0 3:0
3:0 0:0 0:0 1:0 1:0 1:0 1:0 1:0 1:0 1:0 1:0 1:0 1:0 1:0 1:0 1:0 1:0 1:0 1:0 3:0
3:0 0:0 0:0 0:0 0:0 0:0 0:0 0:0 1:0 0:0 0:0 0:0 0:0 0:0 0:0 0:0 0:0 0:0 0:0 3:0
3:0 0:0 0:0 0:0 0:0 0:0 0:0 0:0 1:0 1:0 1:0 0:0 0:0 0:0 0:0 0:0 0:0 0:0 0:0 3:0
3:0 0:0 0:0 0:0 0:0 0:0 0:0 0:0 0:0 0:0 1:0 0:0 0:0 0:0 0:0 0:0 0:0 0:0 0:0 3:0
3:0 0:1 0:2 0:2 0:3 0:0 0:0 0:0 0:0 0:0 1:0 0:0 0:0 0:0 0:0 0:0 0:0 0:0 0:0 3:0
3:0 0:4 1:0 1:0 0:5 0:0 0:0 0:0 1:0 1:0 1:0 0:0 0:0 0:0 0:0 0:0 0:0 0:0 0:0 3:0
3:0 0:4 1:0 1:0 0:5 0:0 1:0 1:0 1:0 0:0 0:0 0:0 0:0 0:0 0:0 0:0 0:0 0:0 0:0 3:0
3:0 0:4 1:0 1:0 1:3 0:2 1:0 0:0 0:0 0:0 0:0 0:0 0:0 0:0 0:0 0:0 0:0 0:0 0:0 3:0
3:0 0:4 1:0 1:0 1:1 0:0 0:0 0:0 0:0 0:0 0:0 0:0 0:0 0:0 0:0 0:0 0:0 0:0 0:0 3:0
3:0 0:4 1:0 1:0 0:5 0:0 0:0 0:0 0:0 0:0 0:0 0:0 0:0 0:0 0:0 0:0 0:0 0:0 0:0 3:0
3:0 0:6 0:7 0:7 0:8 0:0 0:0 0:0 0:0 0:0 0:0 0:0 0:0 0:0 0:0 0:0 0:0 0:0 0:0 3:0
3:0 0:0 0:0 0:0 0:0 0:0 0:0 0:0 0:0 0:0 0:0 0:0 0:0 0:0 0:0 0:0 0:0 0:0 0:0 3:0
3:0 0:0 0:0 0:0 0:0 0:0 0:0 0:0 0:0 0:0 0:0 0:0 0:0 0:0 0:0 0:0 0:0 0:0 0:0 3:0
