20 20
0 0
0:0 0:0 0:0 0:0 0:0 0:0 0:0 0:0 0:0 0:0 0:0 0:0 0:0 0:0 0:0 0:0 0:0 0:0 0:0 0:0
0:0 0:0 0:0 0:0 0:0 0:0 0:0 0:0 0:0 0:0 0:0 0:0 0:0 0:0 0:0 0:0 0:0 0:0 0:0 0:0
0:0 0:0 0:0 0:0 0:0 0:0 0:0 0:0 0:0 0:0 0:0 0:0 0:0 0:0 0:0 0:0 0:0 0:0 0:0 0:0
0:0 0:0 0:0 0:0 0:0 0:0 0:0 0:0 0:0 0:0 0:0 0:0 0:0 0:0 0:0 0:0 0:0 0:0 0:0 0:0
0:0 0:0 0:0 0:0 0:0 0:0 0:0 0:0 0:0 0:0 0:0 0:0 0:0 0:0 0:0 0:0 0:0 0:0 0:0 0:0
0:0 0:0 0:0 0:0 0:0 0:0 0:0 0:0 0:0 0:0 0:0 0:0 0:0 0:0 0:0 0:0 0:0 0:0 0:0 0:0
0:0 0:0 0:0 0:0 0:0 0:0 0:0 0:0 0:0 0:0 0:0 0:0 0:0 0:0 0:0 0:0 0:0 0:0 0:0 0:0
0:0 0:0 0:0 0:0 0:0 0:0 0:0 0:0 0:0 0:0 0:0 0:0 0:0 0:0 0:0 0:0 0:0 0:0 0:0 0:0
0:0 0:0 0:0 0:0 0:0 0:0 0:0 0:0 0:0 0:0 0:0 0:0 0:0 0:0 0:0 0:0 0:0 0:0 0:0 0:0
0:0 0:0 0:0 0:0 0:0 0:0 0:0 0:0 0:0 0:0 0:0 0:0 0:0 0:0 0:0 0:0 0:0 0:0 0:0 0:0
0:0 0:0 0:0 0:0 0:0 0:0 0:0 0:0 0:0 0:0 0:0 0:0 0:0 0:0 0:0 0:0 0:0 0:0 0:0 0:0
2:9 2:9 2:9 2:9 0:0 0:0 0:0 0:0 0:0 0:0 0:0 0:0 0:0 0:0 0:0 0:0 0:0 0:0 0:0 0:0
2:9 2:9 2:9 2:9 0:0 2:9 2:9 2:9 0:0 0:0 0:0 0:0 0:0 0:0 0:0 0:0 0:0 0:0 0:0 0:0
2:1 2:1 2:1 2:1 2:1 2:1 2:1 2:1 0:0 2:9 2:9 2:9 2:9 2:9 3:0 2:9 2:9 2:9 2:9 2:9
2:8 2:6 2:6 2:5 2:1 2:1 2:1 2:1 2:1 2:1 2:1 2:1 2:1 2:1 3:0 2:1 2:1 2:1 2:1 2:1
2:3 2:0 2:0 2:7 2:6 2:5 2:1 2:1 2:1 2:1 3:7 3:3 3:3 3:3 3:1 3:3 3:8 2:1 2:1 2:1
2:3 2:0 2:0 2:0 2:0 2:4 2:1 2:1 2:1 2:1 3:5 3:4 3:4 3:4 3:2 3:4 3:6 2:1 2:1 2:1
2:3 2:0 2:0 2:0 2:0 2:4 2:1 2:1 2:1 2:1 2:1 2:1 2:1 2:1 2:1 2:1 2:1 2:1 2:1 2:1
2:2 2:0 2:0 2:0 2:0 2:4 2:1 2:1 2:1 2:1 2:1 2:1 2:1 2:1 2:1 2:1 2:1 2:1 2:1 2:1
2:0 2:0 2:0 2:0 2:0 2:4 2:1 2:1 2:1 2:1 2:1 2:1 2:1 2:1 2:1 2:1 2:1 2:1 2:1 2:1